28
20
############################
#I    #########        #####
# #### ####### ####### #####
# ## ## ###### ### ### #####
# #  ## ####      ### ######
#  #### ### #### ### ### ###
####### ### ### ### #### ###
####       #### ## ##### ###
#### ########## ##   ##  ###
#####     ####  ####   #####
##### ####### ##############
#   ##  ##### #####        #
### ###       ###  #### ## #
### ### ######## ###### ## #
#### ## ###     ####### ## #
####       ############  # #
##  ###### ###      ### ## #
# ## ######   ######     # #
##### ##################S  #
############################
